FlexTop
(-13, 13, 14, -14)
1.0
1.71350955963
.. .. .. .. .. .. .. .. .. .. .. .. .. .. .. .. .. .. .. .. .. .. .. .. .. .. .. 
.. .. .. .. .. .. .. .. .. ..  6  6  0  0  0  6  6 .. .. .. .. .. .. .. .. .. .. 
.. .. .. .. .. .. .. ..  6  6  6 XX XX XX XX  6  6  6  6 .. .. .. .. .. .. .. .. 
.. .. .. .. .. ..  6  6  6  6  6  6  6  6  6  6  6  6  6  6  6 .. .. .. .. .. .. 
.. .. .. .. ..  6  6  6  6  6  6  6  6  6  6  6  6  6  6  6  6  6 .. .. .. .. .. 
.. .. .. ..  6  6  6  6  6  6  6  6  6  6  6  6  6  6  6  6  6  6  6 .. .. .. .. 
.. .. ..  6  6  6  6  6  6  6  6  6  6  6  6  6  6  6  6  6  6  6  6  6 .. .. .. 
.. .. ..  6  6  6  6  6  6  6  6  6  6  6  6  6  6  6  6  6  6  6  6  6 .. .. .. 
.. ..  6  6  6  6  6  6  6  6  6  6  6  6  6  6  6  6  6  6  6  6  6  6  6 .. .. 
.. ..  6  6  6  6  6  6  6  6  6  6  6  6  6  6  6  6  6  6  6  6  6  6  6 .. .. 
..  6  6  6  6  6  6  6  6  6  6  6 30 30  6  6  6  6  6  6  6  6  6  6  6  6 .. 
..  6  6  6  6  6  6  6  6  6  6 30 30 30 30  6  6  6  6  6  6  6  6  6 XX  6 .. 
..  0  6  6  6  6  6  6  6  6 30 30 30 30 30 30  6  6  6  6  6  6  6  6 XX  0 .. 
..  0  6  6  6  6  6  6  6  6 30 30 30 30 30 30  6  6  6  6  6  6  6  6 XX  0 .. 
..  0  6  6  6  6  6  6  6  6 30 30 30 30 30 30  6  6  6  6  6  6  6  6 XX  0 .. 
..  6  6  6  6  6  6  6  6  6  6 30 30 30 30  6  6  6  6  6  6  6  6  6 XX  6 .. 
..  6  6  6  6  6  6  6  6  6  6  6 30 30  6  6  6  6  6  6  6  6  6  6  6  6 .. 
.. ..  6  6  6  6  6  6  6  6  6  6  6  6  6  6  6  6  6  6  6  6  6  6  6 .. .. 
.. ..  6  6  6  6  6  6  6  6  6  6  6  6  6  6  6  6  6  6  6  6  6  6  6 .. .. 
.. .. ..  6  6  6  6  6  6  6  6  6  6  6  6  6  6  6  6  6  6  6  6  6 .. .. .. 
.. .. ..  6  6  6  6  6  6  6  6  6  6  6  6  6  6  6  6  6  6  6  6  6 .. .. .. 
.. .. .. ..  6  6  6  6  6  6  6  6  6  6  6  6  6  6  6  6  6  6  6 .. .. .. .. 
.. .. .. .. ..  6  6  6  6  6  6  6  6  6  6  6  6  6  6  6  6  6 .. .. .. .. .. 
.. .. .. .. .. ..  6  6  6  6  6  6  6  6  6  6  6  6  6  6  6 .. .. .. .. .. .. 
.. .. .. .. .. .. .. ..  6  6  6 XX XX XX XX  6  6  6  6 .. .. .. .. .. .. .. .. 
.. .. .. .. .. .. .. .. .. ..  6  6  0  0  0  6  6 .. .. .. .. .. .. .. .. .. .. 
.. .. .. .. .. .. .. .. .. .. .. .. .. .. .. .. .. .. .. .. .. .. .. .. .. .. .. 
