Combat Arena
(-15.0, 15.0, 15.0, -15.0)
1.0
-2.26498198509
.. .. .. .. .. .. .. .. .. .. .. .. .. .. .. .. .. .. .. .. .. .. .. .. .. .. .. .. .. .. 
.. .. .. .. .. .. .. .. .. .. .. .. .. .. .. .. .. .. .. .. .. .. .. .. .. .. .. .. .. .. 
.. .. .. XX XX XX XX XX XX XX XX XX XX XX XX XX XX XX XX XX XX XX XX XX XX XX XX XX XX .. 
.. .. XX XX  0  0  0  0  0  0  0  0  0  0  0  0  0  0  0  0  0  0  0  0  0  0  0 XX XX .. 
.. .. XX XX  0  0  0  0  0  0  0  0  0  0  0  0  0  0  0  0  0  0  0  0  0  0  0 XX XX .. 
.. .. XX XX  0  0  0  0  0  0  0  0  0  0  0  0  0  0  0  0  0  0  0  0  0  0  0 XX XX .. 
.. .. XX XX  0  0  0  0  0  0  0  0  0  0  0  0  0  0  0  0  0  0  0  0  0  0  0 XX XX .. 
.. .. XX XX  0  0  0  0  0  0  0  0  0  0  0  0  0  0  0  0  0  0  0  0  0  0  0 XX XX .. 
.. .. XX XX  0  0  0  0  0  0  0  0  0  0  0  0  0  0  0  0  0  0  0  0  0  0  0 XX XX .. 
.. .. XX XX  0  0  0  0  0  0  0  0  0 !! !! !! !!  0  0  0  0  0  0  0  0  0  0 XX XX .. 
.. .. XX XX  0  0  0  0  0  0  0  0  0 !! !! !! !!  0  0  0  0  0  0  0  0  0  0 XX XX .. 
.. .. XX XX  0  0  0  0  0  0  0  0  0 !! !! !! !!  0  0  0  0  0  0  0  0  0  0 XX XX .. 
.. .. XX XX  0  0  0  0  0  0  0  0  0  0  0  0  0  0  0  0  0  0  0  0  0  0  0 XX XX .. 
.. .. XX XX  0  0  0  0  0  0  0  0  0  0  0  0  0  0  0  0  0  0  0  0  0  0  0 XX XX .. 
.. .. XX XX  0  0  0  0  0  0  0  0  0  0  0  0  0  0  0  0  0  0  0  0  0  0  0 XX XX .. 
.. .. XX XX  0  0  0  0  0  0  0  0  0  0  0  0  0  0  0  0  0  0  0  0  0  0  0 XX XX .. 
.. .. XX XX  0  0  0  0  0  0  0  0  0  0  0  0  0  0  0  0  0  0  0  0  0  0  0 XX XX .. 
.. .. XX XX  0  0  0  0  0  0  0  0  0  0  0  0  0  0  0  0  0  0  0  0  0  0  0 XX XX .. 
.. .. XX XX  0  0  0  0  0  0  0  0  0  0  0  0  0  0  0  0  0  0  0  0  0  0  0 XX XX .. 
.. .. XX XX  0  0  0  0  0  0  0 !! !!  0  0  0  0  0  0 !! !!  0  0  0  0  0  0 XX XX .. 
.. .. XX XX  0  0  0  0  0  0  0 !! !!  0  0  0  0  0  0 !! !!  0  0  0  0  0  0 XX XX .. 
.. .. XX XX  0  0  0  0  0  0  0 !! !!  0  0  0  0  0  0 !! !!  0  0  0  0  0  0 XX XX .. 
.. .. XX XX  0  0  0  0  0  0  0  0  0  0  0  0  0  0  0  0  0  0  0  0  0  0  0 XX XX .. 
.. .. XX XX  0  0  0  0  0  0  0  0  0  0  0  0  0  0  0  0  0  0  0  0  0  0  0 XX XX .. 
.. .. XX XX  0  0  0  0  0  0  0  0  0  0  0  0  0  0  0  0  0  0  0  0  0  0  0 XX XX .. 
.. .. XX XX  0  0  0  0  0  0  0  0  0  0  0  0  0  0  0  0  0  0  0  0  0  0  0 XX XX .. 
.. .. XX XX  0  0  0  0  0  0  0  0  0  0  0  0  0  0  0  0  0  0  0  0  0  0  0 XX XX .. 
.. .. XX XX XX XX XX XX XX XX XX XX XX XX XX XX XX XX XX XX XX XX XX XX XX XX XX XX XX .. 
.. .. XX XX XX XX XX XX XX XX XX XX XX XX XX XX XX XX XX XX XX XX XX XX XX XX XX XX XX .. 
.. .. .. .. .. .. .. .. .. .. .. .. .. .. .. .. .. .. .. .. .. .. .. .. .. .. .. .. .. .. 
