LumaZone
(-14, 14, 15, -15)
1.0
0.55206990242
.. .. .. XX XX XX XX XX XX XX XX XX XX XX XX XX XX XX XX XX XX XX XX XX XX XX XX .. .. 
.. XX XX  6  6  6  6  6  6  6  6  6  6  6  6  6  6  6  6  6  6  6  6  6  6  6 XX XX .. 
XX XX  6  6  6  6  6  6  6  6  6  6  6  6  6  6  6  6  6  6  6  6  6  6  6  6  6 XX XX 
XX  6  6  6  6  6  6  6  6  6  6  6  6  6  6  6  6  6  6  6  6  6  6  6  6  6  6  6 XX 
XX  6  6  6  6  6  6  6  6  6  6  6  6  6  6  6  6  6  6  6  6  6  6  6  6  6  6  6 XX 
XX  6  6  6  6  6  6  6  6  6  6  6  6  6  6  6  6  6  6  6  6  6  6  6  6  6  6  6 XX 
XX  6  6  6  6  6  6  6  6  6  6  6  6  6  6  6  6  6  6  6  6  6  6  6  6  6  6  6 XX 
XX  6  6  6  6  6 !! !!  6  6  6  6  6  6  6  6  6  6  6  6 !! !!  6  6  6  6  6  6 XX 
XX  6  6  6  6  6 !! !! !!  6  6  6  6  6  6  6  6  6  6 !! !! !!  6  6  6  6  6  6 XX 
XX  6  6  6  6  6  6 !! !! !!  6  6  6  6  6  6  6  6 !! !! !!  6  6  6  6  6  6  6 XX 
XX  6  6  6  6  6  6  6 !! !!  6  3  3  3  3  3  3  3 !! !!  6  6  6  6  6  6  6  6 XX 
XX  6  6  6  6  6  6  6  6  6  3  1  1  1  1  1  1  1  3  6  6  6  6  6  6  6  6  6 XX 
XX  6  6  6  6  6  6  6  6  6  3  1  0  0  0  0  0  1  3  6  6  6  6  6  6  6  6  6 XX 
XX  6  6  6  6  6  6  6  6  6  3  1  0  0  0  0  0  1  3  6  6  6  6  6  6  6  6  6 XX 
XX  6  6  6  6  6  6  6  6  6  3  1  0  0  0  0  0  1  3  6  6  6  6  6  6  6  6  6 XX 
XX  6  6  6  6  6  6  6  6  6  3  1  0  0  0  0  0  1  3  6  6  6  6  6  6  6  6  6 XX 
XX  6  6  6  6  6  6  6  6  6  3  1  0  0  0  0  0  1  3  6  6  6  6  6  6  6  6  6 XX 
XX  6  6  6  6  6  6  6  6  6  3  1  1  1  1  1  1  1  3  6  6  6  6  6  6  6  6  6 XX 
XX  6  6  6  6  6  6  6  6  6  6  3  3  3  3  3  3  3  6  6  6  6  6  6  6  6  6  6 XX 
XX  6  6  6  6  6  6  6 !! !!  6  6  6  6  6  6  6  6 !! !!  6  6  6  6  6  6  6  6 XX 
XX  6  6  6  6  6  6 !! !! !!  6  6  6  6  6  6  6  6 !! !! !!  6  6  6  6  6  6  6 XX 
XX  6  6  6  6  6 !! !! !!  6  6  6  6  6  6  6  6  6  6 !! !! !!  6  6  6  6  6  6 XX 
XX  6  6  6  6  6 !! !!  6  6  6  6  6  6  6  6  6  6  6  6 !! !!  6  6  6  6  6  6 XX 
XX  6  6  6  6  6  6  6  6  6  6  6  6  6  6  6  6  6  6  6  6  6  6  6  6  6  6  6 XX 
XX  6  6  6  6  6  6  6  6  6  6  6  6  6  6  6  6  6  6  6  6  6  6  6  6  6  6  6 XX 
XX  6  6  6  6  6  6  6  6  6  6  6  6  6  6  6  6  6  6  6  6  6  6  6  6  6  6  6 XX 
XX XX  6  6  6  6  6  6  6  6  6  6  6  6  6  6  6  6  6  6  6  6  6  6  6  6  6 XX XX 
XX XX XX  6  6  6  6  6  6  6  6  6  6  6  6  6  6  6  6  6  6  6  6  6  6  6 XX XX XX 
.. XX XX XX XX XX XX XX XX XX XX XX XX XX XX XX XX XX XX XX XX XX XX XX XX XX XX XX .. 
