ClawTop
(-13, 13, 14, -14)
1.0
0.605376720428
.. .. .. .. .. .. .. .. .. .. .. .. .. .. .. .. .. .. .. .. .. .. .. .. .. .. .. 
.. XX XX  0  0  3  3  3  3  3  3  0  0  0  0  0  3  3  3  3  3  0  0  0 XX XX XX 
XX XX  0  0  0  3  3  3  3  3  3  0  0  0  0  0  3  3  3  3  3  0  0  0  0 XX XX 
..  0  0  0  0  3  3  3  3  3  3  0  0  0  0  0  3  3  3  3  3  0  0  0  0  0 .. 
..  0  0  0  0  0  0  0  0  0  0  0  0  0  0  0  0  0  0  0  0  0  0  0  0  0 .. 
..  0  0  0  0  0  0  0  0  0  0  0  0  0  0  0  0  0  0  0  0  0  0  0  0  0 .. 
..  0  0  0  0  0  0  0  0  0  0  0  0  0  0  0  0  0  0  0  0  0  0  0  0  0 .. 
..  0  0  0  0  0  0  0  0  0  0  0  0  0  0  0  0  0  0  0  0  0  0  0  0  0 .. 
..  0  0  0  0  0  0  0  0  0  0  0  0  0  0  0  0  0  0  0  0  0  0  0  0  0 .. 
..  0  0  0  0  0  0  0  0  0  0  0  0  0  0  0  0  0  0  0  0  0  0  0  0  0 .. 
..  0  0  0  0  0  0  0  0  0  0  0  0  0  0  0  0  0  0  0  0  0  0  0  0  0 .. 
..  0  0  0  0  0  0  0  0  0  0  0  0  0  0  0  0  0  0  0  0  0  0  0  0  0 .. 
.. .. ..  0  0  0  0  0  0  0  0  0  0  0  0  0  0  0  0  0  0  0  0  0 .. .. .. 
.. ..  2  0  0  0  0  0  0  0  0  0  0  0  0  0  0  0  0  0  0  0  0  0  3 .. .. 
.. .. ..  0  0  0  0  0  0  0  0  0  0  0  0  0  0  0  0  0  0  0  0  0  3 .. .. 
..  0  0  0  0  0  0  0  0  0  0  0  0  0  0  0  0  0  0  0  0  0  0  0  0  0 .. 
..  0  0  0  0  0  0  0  0  0  0  0  0  0  0  0  0  0  0  0  0  0  0  0  0  0 .. 
..  0  0  0  0  0  0  0  0  0  0  0  0  0  0  0  0  0  0  0  0  0  0  0  0  0 .. 
..  0  0  0  0  0  0  0  0  0  0  0  0  0  0  0  0  0  0  0  0  0  0  0  0  0 .. 
..  0  0  0  0  0  0  0  0  0  0  0  0  0  0  0  0  0  0  0  0  0  0  0  0  0 .. 
..  0  0  0  0  0  0  0  0  0  0  0  0  0  0  0  0  0  0  0  0  0  0  0  0  0 .. 
..  0  0  0  0  0  0  0  0  0  0  0  0  0  0  0  0  0  0  0  0  0  0  0  0  0 .. 
..  0  0  0  0  0  0  0  0  0  0  0  0  0  0  0  0  0  0  0  0  0  0  0  0  0 .. 
..  0  0  0  0  0  3  3  3  3  3  0  0  0  0  0  3  3  3  3  3  3  0  0  0  0 .. 
XX XX  0  0  0  0  3  3  3  3  3  0  0  0  0  0  3  3  3  3  3  3  0  0  0 XX XX 
XX XX XX  0  0  0  3  3  3  3  3  0  0  0  0  0  3  3  3  3  3  3  0  0 XX XX XX 
XX XX XX .. .. .. .. .. .. .. .. .. .. .. .. .. .. .. .. .. .. .. .. .. XX XX XX 
