Compressor Arena
(-20, 20, 21, -21)
1.0
4.95262050629
.. .. .. .. .. .. .. .. .. .. .. .. .. .. XX !! !! !! !! !! !! !! !! !! !! 50 XX .. .. .. .. .. .. .. .. .. .. .. .. .. .. 
.. .. .. .. .. .. .. .. .. .. .. .. .. .. XX !! !! !! !! !! !! !! !! !! !! 50 XX .. .. .. .. .. .. .. .. .. .. .. .. .. .. 
XX XX XX XX XX XX XX .. .. .. .. .. .. .. XX !! !! !! !! !! !! !! !! !! !! 50 XX .. .. .. .. .. .. .. XX XX XX XX XX XX XX 
XX XX XX XX XX XX XX .. .. .. .. XX XX XX XX !! !! !! !! !! !! !! !! !! !! XX XX XX XX XX .. .. .. .. XX XX XX XX XX XX XX 
XX  0  0  0  0  0 XX .. .. .. XX XX XX XX XX XX 50 50 50 50 50 50 50 50 50 XX XX XX XX XX XX .. .. .. XX  0  0  0  0  0 XX 
XX  0  0  0  0  0 XX .. .. XX XX XX !! !! !! !! 50 50 50 50 50 50 50 50 50 !! !! !! !! XX XX XX .. .. XX  0  0  0  0  0 XX 
XX  0  0  0  0  0 XX .. XX XX XX !! 50 50 50 50 50 50 50 50 50 50 50 50 50 50 50 50 50 !! XX XX XX .. XX  0  0  0  0  0 XX 
XX  0  0  0  0  0 XX XX XX XX !! 50 50 50 50 50 50 50 50 50 50 50 50 50 50 50 50 50 50 50 !! XX XX XX XX  0  0  0  0  0 XX 
XX  0  0  0  0  0 XX XX XX !! 50 50 50 50 50 50 50 50 50 50 50 50 50 50 50 50 50 50 50 50 50 !! XX XX XX  0  0  0  0  0 XX 
XX  1  1  1  1  1 XX XX !! 50 50 50 50 50 50 50 50 50 50 50 50 50 50 50 50 50 50 50 50 50 50 50 !! XX XX  1  1  1  1  1 XX 
XX  4  4  4  4  4 XX XX 50 50 50 50 50 50 50 50 50 50 50 50 50 50 50 50 50 50 50 50 50 50 50 50 50 !! XX  4  4  4  4  4 XX 
XX  7  7  7  7  7 XX XX 50 50 50 50 50 50 50 50 50 50 50 50 50 50 50 50 50 50 50 50 50 50 50 50 50 50 XX  7  7  7  7  7 XX 
XX 10 10 10 10 10 XX XX 50 50 50 50 50 50 50 50 50 50 50 50 50 50 50 50 50 50 50 50 50 50 50 50 50 50 XX 10 10 10 10 10 XX 
XX 12 12 12 12 12 XX XX 50 50 50 50 50 50 50 50 50 50 50 50 50 50 50 50 50 50 50 50 50 50 50 50 50 50 XX 12 12 12 12 12 XX 
XX 16 16 16 16 16 XX XX 50 50 50 50 50 50 50 50 50 50 50 50 50 50 50 50 50 50 50 50 50 50 50 50 50 50 XX 16 16 16 16 16 XX 
XX 19 19 19 19 19 XX XX 50 50 50 50 50 50 50 50 50 50 50 50 50 50 50 50 50 50 50 50 50 50 50 50 50 50 XX 19 19 19 19 19 XX 
XX 22 22 22 22 22 XX XX XX XX XX XX 50 50 50 50 50 50 50 50 50 50 50 50 50 50 50 50 XX XX XX XX XX XX XX 22 22 22 22 22 XX 
XX 24 24 24 24 24 24 XX 30 33 37 40 43 46 50 50 50 50 50 50 50 50 50 50 50 50 50 46 44 41 37 34 30 27 24 24 24 24 24 24 XX 
XX 24 24 24 24 24 24 27 30 33 37 40 43 46 50 50 50 50 50 50 50 50 50 50 50 50 50 46 44 41 37 34 30 27 24 24 24 24 24 24 XX 
XX 24 24 24 24 24 24 27 30 33 37 40 43 46 50 50 50 50 50 50 50 50 50 50 50 50 50 46 44 41 37 34 30 27 24 24 24 24 24 24 XX 
XX 24 24 24 24 24 24 27 30 33 37 40 43 46 50 50 50 50 50 50 50 50 50 50 50 50 50 46 44 41 37 34 30 27 24 24 24 24 24 24 XX 
XX 24 24 24 24 24 24 27 30 33 37 40 43 46 50 50 50 50 50 50 50 50 50 50 50 50 50 46 44 41 37 34 30 27 24 24 24 24 24 24 XX 
XX 24 24 24 24 24 24 27 30 33 37 40 43 46 50 50 50 50 50 50 50 50 50 50 50 50 50 46 44 41 37 34 30 27 24 24 24 24 24 24 XX 
XX 24 24 24 24 24 XX XX 30 33 37 40 43 46 50 50 50 50 50 50 50 50 50 50 50 50 50 46 44 41 37 34 30 27 24 24 24 24 24 24 XX 
XX 22 22 22 22 22 XX XX 50 50 50 50 50 50 50 50 50 50 50 50 50 50 50 50 50 50 50 50 50 50 50 50 50 50 XX 22 22 22 22 22 XX 
XX 19 19 19 19 19 XX XX 50 50 50 50 50 50 50 50 50 50 50 50 50 50 50 50 50 50 50 50 50 50 50 50 50 50 XX 19 19 19 19 19 XX 
XX 16 16 16 16 16 XX XX 50 50 50 50 50 50 50 50 50 50 50 50 50 50 50 50 50 50 50 50 50 50 50 50 50 50 XX 16 16 16 16 16 XX 
XX 12 12 12 12 12 XX XX 50 50 50 50 50 50 50 50 50 50 50 50 50 50 50 50 50 50 50 50 50 50 50 50 50 50 XX 12 12 12 12 12 XX 
XX 10 10 10 10 10 XX XX 50 50 50 50 50 50 50 50 50 50 50 50 50 50 50 50 50 50 50 50 50 50 50 50 50 50 XX 10 10 10 10 10 XX 
XX  7  7  7  7  7 XX XX 50 50 50 50 50 50 50 50 50 50 50 50 50 50 50 50 50 50 50 50 50 50 50 50 50 50 XX  7  7  7  7  7 XX 
XX  4  4  4  4  4 XX XX 50 50 50 50 50 50 50 50 50 50 50 50 50 50 50 50 50 50 50 50 50 50 50 50 50 !! XX  4  4  4  4  4 XX 
XX  1  1  1  1  1 XX XX !! 50 50 50 50 50 50 50 50 50 50 50 50 50 50 50 50 50 50 50 50 50 50 50 !! XX XX  1  1  1  1  1 XX 
XX  0  0  0  0  0 XX XX XX !! 50 50 50 50 50 50 50 50 50 50 50 50 50 50 50 50 50 50 50 50 50 !! XX XX XX  0  0  0  0  0 XX 
XX  0  0  0  0  0 XX XX XX XX !! 50 50 50 50 50 50 50 50 50 50 50 50 50 50 50 50 50 50 50 !! XX XX XX XX  0  0  0  0  0 XX 
XX  0  0  0  0  0 XX .. XX XX XX !! 50 50 50 50 50 50 50 50 50 50 50 50 50 50 50 50 50 !! XX XX XX .. XX  0  0  0  0  0 XX 
XX  0  0  0  0  0 XX .. .. XX XX XX !! !! !! !! 50 50 50 50 50 50 50 50 50 !! !! !! !! XX XX XX .. .. XX  0  0  0  0  0 XX 
XX  0  0  0  0  0 XX .. .. .. XX XX XX XX XX XX 50 50 50 50 50 50 50 50 50 XX XX XX XX XX XX .. .. .. XX  0  0  0  0  0 XX 
XX XX XX XX XX XX XX .. .. .. .. XX XX XX XX !! !! !! !! !! !! !! !! !! !! XX XX XX XX XX .. .. .. .. XX XX XX XX XX XX XX 
XX XX XX XX XX XX XX .. .. .. .. .. .. .. XX !! !! !! !! !! !! !! !! !! !! 50 XX .. .. .. .. .. .. .. XX XX XX XX XX XX XX 
.. .. .. .. .. .. .. .. .. .. .. .. .. .. XX !! !! !! !! !! !! !! !! !! !! 50 XX .. .. .. .. .. .. .. .. .. .. .. .. .. .. 
.. .. .. .. .. .. .. .. .. .. .. .. .. .. XX !! !! !! !! !! !! !! !! !! !! 50 XX .. .. .. .. .. .. .. .. .. .. .. .. .. .. 
