Bridge of Doom
(-12.0, 15.0, 13.0, -16.0)
1.0
2.00222086906
XX XX XX XX XX XX XX XX XX XX XX XX XX XX XX XX XX XX XX XX XX XX XX XX XX 
XX XX XX XX XX XX XX XX XX 27 27 27 27 27 27 27 XX XX XX XX XX XX XX XX XX 
XX 27 27 27 27 27 27 27 27 27 27 27 27 27 27 27 27 27 27 27 27 27 27 27 XX 
XX 27 27 27 27 27 27 27 27 27 27 27 27 27 27 27 27 27 27 27 27 27 27 27 XX 
XX 27 27 27 27 27 27 27 27 27 27 27 27 27 27 27 27 27 27 27 27 27 27 27 XX 
XX 27 27 27 27 27 27 27 27 XX 29 29 29 29 29 XX 27 27 27 27 27 27 27 27 XX 
XX 27 27 27 27 27 27 27 XX XX XX 33 33 33 XX XX XX 27 27 27 27 27 27 27 XX 
XX 27 27 27 27 27 27 27 XX XX XX 36 36 36 XX XX XX 27 27 27 27 27 27 27 XX 
XX 27 27 27 27 27 27 27 XX XX XX 39 39 39 XX XX XX 27 27 27 27 27 27 27 XX 
XX 27 27 27 27 27 27 27 XX XX XX 41 41 41 XX XX XX 27 27 27 27 27 27 27 XX 
XX 27 27 27 27 27 27 27 XX XX XX 41 41 41 XX XX XX 27 27 27 27 27 27 27 XX 
XX 27 27 27 27 27 27 27 XX XX XX 41 41 41 XX XX XX 27 27 27 27 27 27 27 XX 
XX 27 27 27 27 27 27 27 XX XX XX 41 41 41 XX XX XX 27 27 27 27 27 27 27 XX 
XX 27 27 27 27 27 27 27 27 XX XX 41 41 41 XX XX 27 27 27 27 27 27 27 27 XX 
XX 27 27 27 27 27 27 27 27 27 27 41 41 41 27 27 27 27 27 27 27 27 27 27 XX 
XX 27 27 27 27 27 27 27 27 27 27 41 41 41 27 27 27 27 27 27 27 27 27 27 XX 
XX 27 27 27 27 27 27 27 27 27 27 41 41 41 27 27 27 27 27 27 27 27 27 27 XX 
XX 27 27 27 27 27 27 27 27 XX XX 41 41 41 XX XX 27 27 27 27 27 27 27 27 XX 
XX 27 27 27 27 27 27 27 XX XX XX 41 41 41 XX XX XX 27 27 27 27 27 27 27 XX 
XX 27 27 27 27 27 27 27 XX XX XX 41 41 41 XX XX XX 27 27 27 27 27 27 27 XX 
XX 27 27 27 27 27 27 27 XX XX XX 41 41 41 XX XX XX 27 27 27 27 27 27 27 XX 
XX 27 27 27 27 27 27 27 XX XX XX 41 41 41 XX XX XX 27 27 27 27 27 27 27 XX 
XX 27 27 27 27 27 27 27 XX XX XX 39 39 39 XX XX XX 27 27 27 27 27 27 27 XX 
XX 27 27 27 27 27 27 27 XX XX XX 36 36 36 XX XX XX 27 27 27 27 27 27 27 XX 
XX 27 27 27 27 27 27 27 XX XX XX 33 33 33 XX XX XX 27 27 27 27 27 27 27 XX 
XX 27 27 27 27 27 27 27 27 XX 29 29 29 29 29 XX 27 27 27 27 27 27 27 27 XX 
XX 27 27 27 27 27 27 27 27 27 27 27 27 27 27 27 27 27 27 27 27 27 27 27 XX 
XX 27 27 27 27 27 27 27 27 27 27 27 27 27 27 27 27 27 27 27 27 27 27 27 XX 
XX 27 27 27 27 27 27 27 27 27 27 27 27 27 27 27 27 27 27 27 27 27 27 27 XX 
XX XX XX XX XX XX XX XX XX 27 27 27 27 27 27 27 XX XX XX XX XX XX XX XX XX 
XX XX XX XX XX XX XX XX XX XX XX XX XX XX XX XX XX XX XX XX XX XX XX XX XX 
