Electric Arena
(-16, 20, 17, -21)
1.0
-0.81893825531
.. .. .. .. XX XX XX XX XX XX XX XX XX XX XX XX XX XX XX XX XX XX XX XX XX XX XX XX XX .. .. .. .. 
.. .. .. .. XX  0  0  0  0  0  0  0  0  0  0  0  0  0  0  0  0  0  0  0  0  0  0  0 XX XX XX .. .. 
.. XX XX XX  0  0  0  0  0  0  0  0  0  0  0  0  0  0  0  0  0  0  0  0  0  0  0  0  0 XX XX XX .. 
XX XX XX  0  0  0  0  0  0  0  0  0  0  0  0  0  0  0  0  0  0  0  0  0  0  0  0  0  0 XX XX XX XX 
XX XX  0  0  0  0  0  0  0  0  0  0  0  0  0  0  0  0  0  0  0  0  0  0  0  0  0  0  0  0  0 XX XX 
XX  0  0  0  0  0  0  0  0  0  0  0  0  0  0  0  0  0  0  0  0  0  0  0  0  0  0  0  0  0  0  0 XX 
XX  0  0  0  0  0  0  0  0  0  0  0  0  0  0  0  0  0  0  0  0  0  0  0  0  0  0  0  0  0  0  0 XX 
XX  0  0  0  0  0  0  0  0  0  0  0  0  0  0  0  0  0  0  0  0  0  0  0  0  0  0  0  0  0  0  0 XX 
XX  0  0  0  0  0  0  0  0  0  0  0  0  0  0  0  0  0  0  0  0  0  0  0  0  0  0  0  0  0  0  0 XX 
XX  0  0  0  0  0  0  0  0  0  0  0  0  0  0  0  0  0  0  0  0  0  0  0  0  0  0  0  0  0  0  0 XX 
XX  0  0  0  0  0  0  0  0  0  0  0  0  0  0  0  0  0  0  0  0  0  0  0  0  0  0  0  0  0  0  0 XX 
XX  0  0  0  0  0  0  0  0  0  0  0  0  0  0  0  0  0  0  0  0  0  0  0  0  0  0  0  0  0  0  0 XX 
XX  0  0  0  0  0  0  0  0  0  0  0  0  0  0  0  0  0  0  0  0  0  0  0  0  0  0  0  0  0  0  0 XX 
XX  0  0  0  0  0  0  0  0  0  0  0  0  0  0  0  0  0  0  0  0  0  0  0  0  0  0  0  0  0  0  0 XX 
XX  0  0  0  0  0  0  0  0  0  0  0 !! !! !! !! !! !! !! !! !!  0  0  0  0  0  0  0  0  0  0  0 XX 
XX  0  0  0  0  0  0  0  0  0  0  0 !! !! !! !! !! !! !! !! !!  0  0  0  0  0  0  0  0  0  0  0 XX 
XX  0  0  0  0  0  0  0  0  0 !! !! !! !! !! !! !! !! !! !! !! !! !!  0  0  0  0  0  0  0  0  0 XX 
XX  0  0  0  0  0  0  0  0  0 !! !! !! !! !! !! !! !! !! !! !! !! !!  0  0  0  0  0  0  0  0  0 XX 
XX  0  0  0  0  0  0  0  0  0 !! !! !! !! !! !! !! !! !! !! !! !! !!  0  0  0  0  0  0  0  0  0 XX 
XX  0  0  0  0  0  0  0  0  0 !! !! !! !! !! !! !! !! !! !! !! !! !!  0  0  0  0  0  0  0  0  0 XX 
XX  0  0  0  0  0  0  0  0  0 !! !! !! !! !! !! !! !! !! !! !! !! !!  0  0  0  0  0  0  0  0  0 XX 
XX  0  0  0  0  0  0  0  0  0 !! !! !! !! !! !! !! !! !! !! !! !! !!  0  0  0  0  0  0  0  0  0 XX 
XX  0  0  0  0  0  0  0  0  0 !! !! !! !! !! !! !! !! !! !! !! !! !!  0  0  0  0  0  0  0  0  0 XX 
XX  0  0  0  0  0  0  0  0  0 !! !! !! !! !! !! !! !! !! !! !! !! !!  0  0  0  0  0  0  0  0  0 XX 
XX  0  0  0  0  0  0  0  0  0 !! !! !! !! !! !! !! !! !! !! !! !! !!  0  0  0  0  0  0  0  0  0 XX 
XX  0  0  0  0  0  0  0  0  0  0  0 !! !! !! !! !! !! !! !! !!  0  0  0  0  0  0  0  0  0  0  0 XX 
XX  0  0  0  0  0  0  0  0  0  0  0 !! !! !! !! !! !! !! !! !!  0  0  0  0  0  0  0  0  0  0  0 XX 
XX  0  0  0  0  0  0  0  0  0  0  0 !! !! !! !! !! !! !! !! !!  0  0  0  0  0  0  0  0  0  0  0 XX 
XX  0  0  0  0  0  0  0  0  0  0  0  0  0  0  0  0  0  0  0  0  0  0  0  0  0  0  0  0  0  0  0 XX 
XX  0  0  0  0  0  0  0  0  0  0  0  0  0  0  0  0  0  0  0  0  0  0  0  0  0  0  0  0  0  0  0 XX 
XX  0  0  0  0  0  0  0  0  0  0  0  0  0  0  0  0  0  0  0  0  0  0  0  0  0  0  0  0  0  0  0 XX 
XX  0  0  0  0  0  0  0  0  0  0  0  0  0  0  0  0  0  0  0  0  0  0  0  0  0  0  0  0  0  0  0 XX 
XX  0  0  0  0  0  0  0  0  0  0  0  0  0  0  0  0  0  0  0  0  0  0  0  0  0  0  0  0  0  0  0 XX 
XX  0  0  0  0  0  0  0  0  0  0  0  0  0  0  0  0  0  0  0  0  0  0  0  0  0  0  0  0  0  0  0 XX 
XX  0  0  0  0  0  0  0  0  0  0  0  0  0  0  0  0  0  0  0  0  0  0  0  0  0  0  0  0  0  0  0 XX 
XX  0  0  0  0  0  0  0  0  0  0  0  0  0  0  0  0  0  0  0  0  0  0  0  0  0  0  0  0  0  0  0 XX 
XX XX  0  0  0  0  0  0  0  0  0  0  0  0  0  0  0  0  0  0  0  0  0  0  0  0  0  0  0  0  0 XX XX 
XX XX XX XX  0  0  0  0  0  0  0  0  0  0  0  0  0  0  0  0  0  0  0  0  0  0  0  0  0  0 XX XX XX 
.. XX XX XX  0  0  0  0  0  0  0  0  0  0  0  0  0  0  0  0  0  0  0  0  0  0  0  0  0 XX XX XX .. 
.. .. XX XX XX  0  0  0  0  0  0  0  0  0  0  0  0  0  0  0  0  0  0  0  0  0  0  0 XX XX XX .. .. 
.. .. .. XX XX XX XX XX XX XX XX XX XX XX XX XX XX XX XX XX XX XX XX XX XX XX XX XX XX XX .. .. .. 
